#####################
#...................#
#...................#
#...................#
#...................#
#...................#
#.......###.........#
#...................#
#...................#
#...................#
#...................#
#...................#
#...................#
#...................#
#####################
