#####################
#...................#
#...................#
#...................#
#...................#
#....#.........#....#
#....#..###....#....#
#....#.........#....#
#....#.........#....#
#....#.........#....#
#....###########....#
#...................#
#...................#
#...................#
#####################
